あいてむ	\item	名詞	
あぺんでぃっくす	\appendix	名詞	
いたりっく	\textit{}	名詞		
いんたーてきすと	\intertext{}	名詞	
えんえん	\\	名詞	
えんど	\end{}	名詞	
えんぱ	\emph{}	名詞	
かじょうがき	\begin{enumerate}\end{enumerate}	名詞	
かじょうがき	\begin{itemize}\end{itemize}	名詞	
きゃぷしょん	\caption{}	名詞	
くりあぺーじ	\clearpage	名詞	
さいと	\cite{}	名詞	
さぶさぶせくしょん	\subsubsection{}	名詞	
さぶせくしょん	\subsection{}	名詞	
しき	$\$	名詞	
しきれふ	式\eqref{eq:}	名詞	
すうしき	\begin{align} \end{align}	名詞	
すぺーす	\\~\\	名詞	
ずれふ	式\ref{fig:}	名詞	
せくしょん	\section{}	名詞	
せんたー	\centering	名詞	
たてすぺーす	\vspace{mm}	名詞	
ちゃぷたー	\chapter{}	名詞	
でぃすぷれいすたいる	\displaystyle	名詞	
てきすとすたいる	\textstyle	名詞	
にゅうぺーじ	\newpage	名詞	
のんいんでんと	\noindent	名詞	
のんなんばー	\nonumber	名詞	
びぎん	\begin{}	名詞	
ひょうれふ	表\ref{ta:}	名詞	
ぶんすう	\frac{}{}	名詞	
ぼーるど	\textbf{}	名詞	
よこすぺーす	\hspace{mm}	名詞	
るび	\ruby{}{}	名詞	
れーべる	\label{}	名詞	
れーべる	\label{:}	名詞	
れふ	\ref{}	名詞	
ろーまん	\textrm{}	名詞	
